1111111
1111111
1111111
1112111
4014414
4141414
