1111111111111
10010P0C000C1
1000010C1C101
100010EC0CC01
1111111111111
