1111111111111
10010000000C1
1G00011111001
1PG011E000001
1111111111111
