11111111111111111111111111111111111111
1111111G0G000E1111P0C0GG00000000001111
111111G0G00G0001111G00000111111G0G0011
11111G0G011G0G01111111111111111G0G0011
1111G0G0111G0G01111111111111111G0G0011
111G0G01111G0G01111111111111111G0G0011
11G0G011111G0G01111111111111111G0G0111
1G0G0111111G0G011111111111100000000001
1G0G00G00G00G00G011111G00000G011111111
1111111111G0G0011111G0G001111111111111
11111111111G0001111G0G0011111111111111
11111111111G0G01111G0G0011111111111111
11111111111G0G01111G0G0011111111111111
1111111111G000GG0000GG0001111111G0GGG1
111111111G0G00000GG0000G00G00G00G00G01
11111111111111111111111111111111111111
