1111111111111
1CCGCCCGCCCE1
10GCCPCCCCCC1
100CCCGC1CCC1
1111111111111
