1111111111
100C000E01
10111C1101
1000000001
101C111101
1000000001
1111111111

