111111
1P1001
1C1001
1E1001
111111
